1111111111
1P0C000101
100000C101
1C0E0C01C1
1111111111