111111111111111111111111111111111111111111111111111111111111
1P0000000000000011111111111111000000000000C00000000000000001
101111111111110000000000000000011111111111111111111111111101
100000000000001111111111111000000000000000000000000000000001
111111000000000000000000000111111111111111111111111111111101
100001000111111111111111110000000000000000000000000000000001
100001000100000000000C00000011111111111111111111111111111101
100001000101111111111111110000000000000000000000000000000001
100001000100000000000000000000000000011111111111111111111101
100001000101111111111111111111111000000000000000000000000001
100001000100000000000000000000001111111111111111111111111101
100001000101111111111111111110000000000000C00000000000000001
100001000100000000000000000000011111111111111111111111111101
10C001000101111111111111111000000000000000000000000000000001
100001000100000000000000000111111111111111111111111111111101
100001000101111111111111110000000000000000000000000000000001
100001000100000000000000000000C00111111111111111111111111101
100001000101111111111111111111110000000000000000000000000001
100001000100000000000000000000001111111111111111111111111101
100001000101111111111111110000000000000000000000000000000001
100001000100000000000000000011111111111111111111111111111101
100001000101111111111111110000000000000000000000000000000001
100001000100000000000000000000000000000000000000000000000001
100001000101111111111111111111111111111111111111111111111101
1000010001000000000000000000000000000000000000000000000000C1
100001000101111111111111111111111111111111111111111111111101
1000000000000000000000000000000000000000000000000000000000C1
1111111111111111111111111111111111111111111111111111111111E1
111111111111111111111111111111111111111111111111111111111111