111111111111111111111111111111111111111111111111111111111111
1P0000000000111110000000C0000000000C00011110000000000C000001
101111111100000001111111111111111111000000001111111111111101
100000C00011111111000000000000000001111111110000000000000001
1011111100000C0000111111111111111111000000001111111111111101
1000C0001111111100000000C00000000000111111110000000000000001
1011111100000000111111111111111111110000C0001111111111111101
10000000000000C000000000000000000000000000000000000000000001
101111111111111111111111111111111111111111111111111111111101
1000000000C000000000000000000000000000000000000000000C000001
100000000000000000000000000000000000000000000000000000000001
100000000000111110000000C0000000000C00011110000000000C000001
101111111100000001111111111111111111000000001111111111111101
100000C00011111111000000000000000001111111100000000000000001
1011111100000C0000111111111111111111000000001111111111111101
1000C0001111111000000000C00000000000111111100000000000000001
1011111100000000111111111111111111110000C0001111111111111101
10000000000000C000000000000000000000000000000000000000000001
101111111111111111111111111111111111111111111111111111111101
1000000000C000000000000000000000000000000000000000000C000001
100000000000000000000000000000000000000000000000000000000001
100000000000111100000000C0000000000C00011110000000000C000001
101111111100000001111111111111111111000000001111111111111101
1011111100000C0000111111111111111111000000001111111111111101
1000C0001111111000000000C00000000000011111100000000000000001
1011111100000000111111111111111111110000C0001111111111111101
10000000000000C000000000000000000000000000000000000000000001
1000000000C000000000000000000000000000000000000000000C0000E1
111111111111111111111111111111111111111111111111111111111111